                    X                 X               X
                                      X             XXX
XXXXXXXXXXXXXXXX            XXXXX              XXXX    
                                                       
                                                       
                                                      X
             XXXXXXXXXXXXXXXXXXXXXXXXX   XXXXXXXXX    X
XXXXX    XXXXX  G       XXXXXXXXXXXXXX                X
        X               XXXXXXXXXXXXXX                X
X    XXXX                                              
    X                                                  
   X                                                   
  SX                                                   